##############
####..E...E..#
####.#.###.#.#
#.E.E#...#..##
#P##..#.###.##
#.#########.##
#FFF...#F....#
######.#####.#
###..E......I#
##############